type octile
height 1
width 5
map
..@...
..@...
@@@...